contig	uniqueGene
CTGAACTGTATCTAGAGGAACCAGGATGTGCAGAGTCGGCAATCCAGA	HECW2-AS1
GTGACTGGAGTTCAGACGTGTGGAAACCCGAGCCCTGCCGGAT	COL1A1
CTCTGCACCCCACTCGTGGGGGAACACAGCCGCTCCCCTCTGCTCTGCA	EFNA2
AAATAGTTAGATATTCTAGATTTACATTAAATTGTAAAATAAATGGACTTATT	GTSE1
ATGGTCCTGCTGGTGCTCCTGGTACTCCCGAG	COL1A1
TCCCATCACACTTCAATGTTATTAATAAAAA	PGM5-AS1
GGCACTGGTTCGATGATAATGCTCAATGACAGTA	MYBPC1
TTGGCAAGCTTTCGGAAACAAAACAGGCAAAATTTTGTGATGATAAATATCACAGTTGCCACGCAGGCCAGCAGGAATGCTAT	UGT2B15
GTTTTCATTATAGCTGTCCGCAGGCTTGTCCAAAAGGAAAC	GMNN
AACTCTATCTGAAATCCCAAAAAAAAAAAAA	COL3A1
TACAATAAAGTCTTTATTTTTTTGCAGAGTATTATTGTTATTGCTTAAAATTGGAAAGCCAAAAAAAAGCACAATAAAGGGAAGTACAAGGGGTAATAAATAGATTACATCCTAACAATGTGTTCTCTTTTATCAGAAACCTGTACACTTTTAAAATTATGTAATTAAGCCAGACGAAATGGATTATTCAGAAGCACCTGTAAAAATTCAATTGACAGACTAATTTGCAGTGAATACACAGGCGTGCTTATTTTAAAAGCCTTTCCACATGATTACATTATACATAAAAAGAACTGGCAAGTGTAGTTGCAGGCTGAACTATATTTTTTATTGCCTTTACTCTGTGCATACTTATTCCAACCACTGAATTTACCAATTTTCAATTAGAATTTTCCAAGGAAATTAACAATTATTGTACCTCATCTACAATCAGCTTTATCTCTGAAGTCTATTTTCCTAAGGAAAAATTAAAGAACTTGCATGGGCGTATTAAGTAATATTCACATTTAGAAAAATATTGCATCAGGATGTTGAAAGGAGATAGAGGCAGCAACACACATTTTGGGGGCATTACAGGCCCATGGATCATAGCCATTGCATCATACACATTATTCCATGTAATCATCCCCCAAATCCTTTGAGTTAGGTTAACAACTAGTATTCTGTTAAATGCATGGAATTAAATGGAAAACTGGAAAAGGTGAATAGATACAGGCAAAGGTGGAAGCTATTCTAAAAGCAAAAGGCTGGAATGAAGGAAGGAGAGATATGAGACTCAAGCAAGTCAAGAGTCACTGAACCAAATTAGAGATAGAAGTAGTGAGATAGCAAGATATTGAGAGAGAGAGAGAGAGAGAGAGAGAG	AC069228.1
TTAAATCAGGTAATAATTAAAAAAAAAAAAAGCATATGCTATAGCCCCA	ASPN
GAAAAAGTTAGATATGCGTACTCTTTTTTTAATACATAAATGAAAAAC	ctg_20
CAAACACAGCTTCCAAACCCAGGGCTTGCGCTTGCCTTTGCCTCTTCCACCGCG	HOPX
CTGTCATCGGCCACAGCATTTCTACCATTGAAAACACAGGTAGTGACATAGATGA	USP9YP32
CCTCCGCCCGCCCCGCCTCCTTATCTTCTCCCTGGATTCCTGAGGGCTGCCTGGAAGAGGATGAATGTCCACACCTCCCTGGAGGAGCCCACGGTAGGGGACGGGAGGCTGACACATAGAGAGGGCGACACAGTGCACCCAGGACTGTGACAGAAATCCATGCAAAGTGCTGAGGAGAAGCCAGCAGGTTCTGCCTGGAAGGTCGGGGATGGCTTACCAGGGAGGGGACAAT	ctg_23
CGCCTTCCATGTGATCATCCTGGTCAATGAA	PTPRN2
TAATTGTTACCAAACAAAAATATCCACTCAAAATACAAT	SLC22A3
GACTTCGTCCTCGTTTGGGAGGAGGACCTGAAGCTAGACAGGCAGCAGGACAGTGCCGCCCGGGACAGAACAGACATGCACAGGACCTGGCGGG	ANO7
CCCCTTGTCACCAGGGGCACCAGCAGGGCCA	COL1A1
CCTGTATCCCCAGCACTTTGGGAGGCCGAGACGGGAGG	CD38
CACCCCGCTTGCTCCGGCCGATCTGGCCCAGC	CAMK2N1
AGACACATCTTGCAGCATTTTTCTTAAGGCA	SFRP4
TTTTTTTTTTTTAATTATTACCTGATTTAAAAATCTCTGTAAAAACGTGTAGTGTTTCATAAAATCTGTAACTCGCATTTTAATGATC	ASPN
AGGACTCTAGGGGCCTGGGTTCTGCTGGAGGG	TROAP
TATTCCAATTACAAGCGTTCGGCCCCTTCCTTAGAGAGTCCATATCTCAGCACTCATGCTG	SRD5A2
